R 500 500
NO textures/eagle.xpm
SO textures/redbrick.xpm
WE textures/purplestone.xpm
EA textures/greystone.xpm

S textures/barrel.xpm
F 128,0,0
C 255,255,255

11111111111111111111111111111111111111111111111111
12222222222222222222222222222222222222222222222221
12222222222222222222222222222222222222222222222221
12222222222222222222222222222222222222222222222221
12222222222222222222222222222222222222222222222221
12222222222222222222222222222222222222222222222221
12222222222222222222222222222222222222222222222221
12222222222222222222222222222222222222222222222221
12222222222222222222222222222222222222222222222221
12222222222222222222222222222222222222222222222221
12222222222222222222222222222222222222222222222221
12222222222222222222222222222222222222222222222221
12222222222222222222222222222222222222222222222221
12222222222222222222222222222222222222222222222221
12222222222222222222222222222222222222222222222221
12222222222222222222222222222222222222222222222221
12222222222222222222222222222222222222222222222221
12222222222222222222222222222222222222222222222221
12222222222222222222222222222222222222222222222221
12222222222222222222222222222222222222222222222221
12222222222222222222222222222222222222222222222221
12222222222222222222222222222222222222222222222221
12222222222222222222222222222222222222222222222221
12222222222222222222222222222222222222222222222221
12222222222222222222222222222222222222222222222221
12222222222222222222222222222222222222222222222221
12222222222222222222222222222222222222222222222221
12222222222222222222222222222222222222222222222221
12222222222222222222222222222222222222222222222221
12222222222222222222222222222222222222222222222221
12222222222222222222222222222222222222222222222221
12222222222222222222222222222222222222222222222221
12222222222222222222222222222222222222222222222221
12222222222222222222222222222222222222222222222221
12222222222222222222222222222222222222222222222221
12222222222222222222222222222222222222222222222221
12222222222222222222222222222222222222222222222221
12222222222222222222222222222222222222222222222221
12222222222222222222222222222222222222222222222221
12222222222222222222222222222222222222222222222221
12222222222222222222222222222222222222222222222221
12222222222222222222222222222222222222222222222221
12222222222222222222222222222222222222222222222221
12222222222222222222222222222222222222222222222221
12222222222222222222222222222222222222222222222221
12222222222222222222222222222222222222222222222221
122222222222222222222222N2222222222222222222222221
12222222222222222222222222222222222222222222222221
12222222222222222222222222222222222222222222222221
11111111111111111111111111111111111111111111111111